sample	celltype	comp2	cc
AAACCCACACGAGAAC-1	Fibroblast	vsmcfibro	control
AAACCCAGTACAACGG-1	Fibroblast	vsmcfibro	control
AAACCCATCTCTCGAC-1	Fibroblast	vsmcfibro	control
AAACGAAAGAAAGTCT-1	T-cells	NA	control
AAAGAACAGCAATAGT-1	RBC	NA	control
AAAGAACGTTCGTACA-1	Macrophages	NA	control
AAAGGATGTTCGGGTC-1	Endothelial	endo	control
AAAGGGCTCTAAGCGT-1	B-cells	NA	control
AAAGTCCCATTATGCG-1	T-cells	NA	control
AAATGGAAGTCCCTAA-1	Endothelial	endo	control
AAATGGAGTTCGAACT-1	Fibroblast	vsmcfibro	control
AACAAAGAGGAGTCTG-1	Fibroblast	vsmcfibro	control
AACAAAGGTGACTGTT-1	T-cells	NA	control
AACAAGACATCCAACA-1	VSMC	vsmcfibro	control
AACAAGATCCAAACCA-1	B-cells	NA	control
AACAAGATCCTCGCAT-1	Fibroblast	vsmcfibro	control
AACAGGGTCTCGTGGG-1	Fibroblast	vsmcfibro	control
AACCAACTCATCGCAA-1	T-cells	NA	control
AACCATGCATATCTGG-1	B-cells	NA	control
AACCCAACAACGCATT-1	Macrophages	NA	control
AACCCAACACGCGTCA-1	T-cells	NA	control
AACCCAACAGAGATTA-1	B-cells	NA	control
AACCTGAAGTATGGAT-1	RBC	NA	control
AACGGGAAGCGCGTTC-1	Endothelial	endo	control
AACGTCATCTGCGATA-1	RBC	NA	control
AACTTCTCATGGAACG-1	Fibroblast	vsmcfibro	control
AAGAACAAGTCTCGTA-1	Fibroblast	vsmcfibro	control
AAGAACACAGAAACCG-1	Fibroblast	vsmcfibro	control
AAGAACAGTGATCGTT-1	RBC	NA	control
AAGAACATCCCATGGG-1	Fibroblast	vsmcfibro	control
AAGACTCAGCCGTTAT-1	Fibroblast	vsmcfibro	control
AAGCCATGTTGCAACT-1	VSMC	vsmcfibro	control
AAGCGAGAGGTCTGGA-1	Endothelial	endo	control
AAGGAATGTAACGTTC-1	Endothelial	endo	control
AAGGTAAGTCCACAGC-1	Fibroblast	vsmcfibro	control
AAGGTAATCCCTAGGG-1	Fibroblast	vsmcfibro	control
AAGTACCCAGCCCACA-1	T-cells	NA	control
AAGTCGTGTCCATCTC-1	Fibroblast	vsmcfibro	control
AAGTCGTTCGCCTTGT-1	Fibroblast	vsmcfibro	control
AAGTGAAGTACTAACC-1	Endothelial	endo	control
AAGTTCGCAGACTCTA-1	RBC	NA	control
AATAGAGAGATAGGGA-1	Endothelial	endo	control
AATCACGAGAAACCCG-1	Fibroblast	vsmcfibro	control
AATCACGCAGCATGCC-1	Fibroblast	vsmcfibro	control
AATCACGCATTGTACG-1	T-cells	NA	control
AATCACGGTGAGGAAA-1	Fibroblast	vsmcfibro	control
AATCGACGTCCTCAGG-1	Fibroblast	vsmcfibro	control
AATCGACGTCTCAAGT-1	Fibroblast	vsmcfibro	control
AATCGTGCAAGTTGGG-1	T-cells	NA	control
AATCGTGGTCATCGGC-1	Fibroblast	vsmcfibro	control
AATGAAGGTGCCTATA-1	T-cells	NA	control
AATGACCGTCGCTTAA-1	VSMC	vsmcfibro	control
AATGACCTCTAACGCA-1	Endothelial	endo	control
AATGCCAAGTAATACG-1	Fibroblast	vsmcfibro	control
AATGGAAGTCCAACGC-1	VSMC	vsmcfibro	control
AATGGAAGTTGTACGT-1	Fibroblast	vsmcfibro	control
AATGGCTCACCTGCTT-1	T-cells	NA	control
AATGGCTTCTCGCAGG-1	Fibroblast	vsmcfibro	control
AATTCCTCAACTACGT-1	Fibroblast	vsmcfibro	control
AATTTCCAGTATCTGC-1	Fibroblast	vsmcfibro	control
AATTTCCGTCCGATCG-1	Endothelial	endo	control
ACAAAGACACGGGTAA-1	B-cells	NA	control
ACAAAGACAGAGATGC-1	Macrophages	NA	control
ACAAAGACAGTGACCC-1	RBC	NA	control
ACAACCACAACTGATC-1	T-cells	NA	control
ACAACCACAAGCGGAT-1	T-cells	NA	control
ACAAGCTGTTTATGCG-1	Fibroblast	vsmcfibro	control
ACACAGTCAGGTGAGT-1	Fibroblast	vsmcfibro	control
ACACCAAAGGTGCATG-1	VSMC	vsmcfibro	control
ACAGAAACAAGAATGT-1	RBC	NA	control
ACAGAAATCGGTCGAC-1	Fibroblast	vsmcfibro	control
ACAGGGAGTAACGCGA-1	Fibroblast	vsmcfibro	control
ACATCCCTCACTCGAA-1	RBC	NA	control
ACATCGACAACCTAAC-1	VSMC	vsmcfibro	control
ACATTTCCAGTTCTAG-1	Endothelial	endo	control
ACATTTCGTCTGCATA-1	RBC	NA	control
ACCAACAGTACCATAC-1	VSMC	vsmcfibro	control
ACCAACAGTGACTGAG-1	T-cells	NA	control
ACCACAAAGCGCCTCA-1	Fibroblast	vsmcfibro	control
ACCATTTAGTAAACTG-1	T-cells	NA	control
ACCATTTCATCGGAGA-1	Fibroblast	vsmcfibro	control
ACCATTTTCTCCGTGT-1	Fibroblast	vsmcfibro	control
ACCCTCAGTGGACTGA-1	Endothelial	endo	control
ACCGTTCAGTACGAGC-1	Endothelial	endo	control
ACCTACCCACGTACAT-1	Endothelial	endo	control
ACCTGTCAGATGCTGG-1	Endothelial	endo	control
ACCTGTCCAGCGCGTT-1	T-cells	NA	control
ACGATCACATGGTGGA-1	Fibroblast	vsmcfibro	control
ACGATCATCAAGAGTA-1	T-cells	NA	control
ACGATCATCCCAATAG-1	Fibroblast	vsmcfibro	control
ACGGAAGAGAATAGTC-1	Endothelial	endo	control
ACGGTCGAGCCTCGTG-1	Fibroblast	vsmcfibro	control
ACGGTCGCATGGACAG-1	T-cells	NA	control
ACGTAACCAGCTCGGT-1	VSMC	vsmcfibro	control
ACGTAACTCGTTCTAT-1	RBC	NA	control
ACGTAGTAGAGTTGTA-1	B-cells	NA	control
ACGTCCTAGATCGCTT-1	Macrophages	NA	control
ACTACGAAGAAGCGGG-1	Fibroblast	vsmcfibro	control
ACTACGATCAGGAAAT-1	T-cells	NA	control
ACTATTCAGGGAGGCA-1	Endothelial	endo	control
ACTCTCGCATACCATG-1	RBC	NA	control
ACTGATGCACTACGGC-1	Macrophages	NA	control
ACTGCAAAGGAGACCT-1	Endothelial	endo	control
ACTGTGATCTCTTCAA-1	Endothelial	endo	control
ACTTAGGGTCAACGCC-1	Macrophages	NA	control
ACTTATCAGCAGGCTA-1	B-cells	NA	control
ACTTATCGTATCCTCC-1	T-cells	NA	control
ACTTCCGAGCTACAAA-1	B-cells	NA	control
ACTTCGCCATCATTTC-1	Fibroblast	vsmcfibro	control
ACTTTCATCCGTTGGG-1	B-cells	NA	control
ACTTTGTCAATTGCCA-1	Macrophages	NA	control
AGAACAAAGATTCGCT-1	VSMC	vsmcfibro	control
AGAACCTTCTCATTGT-1	T-cells	NA	control
AGAAGCGCACGCAAAG-1	B-cells	NA	control
AGAAGTAAGAGTCGAC-1	Fibroblast	vsmcfibro	control
AGACACTAGATGCGAC-1	Fibroblast	vsmcfibro	control
AGACCATCACTGAGTT-1	Fibroblast	vsmcfibro	control
AGACCCGGTTTACCAG-1	Fibroblast	vsmcfibro	control
AGACCCGTCATGCGGC-1	Macrophages	NA	control
AGACTCACACTGGATT-1	RBC	NA	control
AGACTCAGTCCCACGA-1	B-cells	NA	control
AGAGAATAGCAGCCTC-1	B-cells	NA	control
AGAGAATCAACTAGAA-1	Macrophages	NA	control
AGAGAATGTTCTCCCA-1	RBC	NA	control
AGAGAATTCATACAGC-1	Fibroblast	vsmcfibro	control
AGAGAGCGTTGGAGAC-1	Fibroblast	vsmcfibro	control
AGAGAGCTCCATTGCC-1	Fibroblast	vsmcfibro	control
AGAGCAGAGCTGACCC-1	Endothelial	endo	control
AGAGCAGGTTCCGCGA-1	T-cells	NA	control
AGATCGTTCAGCGCAC-1	Macrophages	NA	control
AGATGCTCAACTGCTA-1	Endothelial	endo	control
AGCCACGCAAACTAGA-1	Fibroblast	vsmcfibro	control
AGCGCCATCTTGGGCG-1	T-cells	NA	control
AGCGCTGGTACGCTAT-1	RBC	NA	control
AGCGTATCAAATGCGG-1	Fibroblast	vsmcfibro	control
AGCGTATTCAACCCGG-1	Fibroblast	vsmcfibro	control
AGCTACAAGACATACA-1	Endothelial	endo	control
AGCTTCCCAAGACCGA-1	B-cells	NA	control
AGCTTCCCACCAATTG-1	Fibroblast	vsmcfibro	control
AGCTTCCGTGAGGATC-1	Fibroblast	vsmcfibro	control
AGCTTCCGTTGTGCAT-1	RBC	NA	control
AGGAATATCTTACTGT-1	Endothelial	endo	control
AGGAGGTAGCACAAAT-1	Fibroblast	vsmcfibro	control
AGGAGGTCAGAGTGTG-1	Fibroblast	vsmcfibro	control
AGGAGGTCAGCGCGTT-1	RBC	NA	control
AGGCATTGTAGTATAG-1	RBC	NA	control
AGGCCACAGGAGCAAA-1	VSMC	vsmcfibro	control
AGGCCACCAGGTAGTG-1	T-cells	NA	control
AGGCCACGTGTGAGCA-1	VSMC	vsmcfibro	control
AGGCTGCCACTCCTGT-1	B-cells	NA	control
AGGCTGCGTACCCAGC-1	B-cells	NA	control
AGGGAGTCAGACACCC-1	RBC	NA	control
AGGGCCTGTTCCATTT-1	Macrophages	NA	control
AGGGCTCTCCTTGGAA-1	Macrophages	NA	control
AGGGTCCCATGGGTCC-1	VSMC	vsmcfibro	control
AGGGTGATCAGAGTGG-1	Fibroblast	vsmcfibro	control
AGGTAGGGTAGACTGG-1	Fibroblast	vsmcfibro	control
AGGTCTAAGATACTGA-1	Endothelial	endo	control
AGGTGTTCAGTAACCT-1	Macrophages	NA	control
AGGTTACGTGAGGCAT-1	T-cells	NA	control
AGTAACCAGTTGGGAC-1	Fibroblast	vsmcfibro	control
AGTAACCGTGCCGGTT-1	Fibroblast	vsmcfibro	control
AGTACTGGTGTGTCCG-1	B-cells	NA	control
AGTACTGTCTAGAACC-1	B-cells	NA	control
AGTAGCTAGGACTTCT-1	Fibroblast	vsmcfibro	control
AGTAGTCCATGTGCCG-1	T-cells	NA	control
AGTAGTCTCCCTAGGG-1	Endothelial	endo	control
AGTCAACAGCCTGACC-1	Endothelial	endo	control
AGTCACACATGACAAA-1	Macrophages	NA	control
AGTCACAGTGATTAGA-1	B-cells	NA	control
AGTCACAGTTGTCATG-1	B-cells	NA	control
AGTCATGAGACCAAGC-1	Macrophages	NA	control
AGTCATGTCGCTTAAG-1	RBC	NA	control
AGTCTCCAGCGTTAGG-1	Fibroblast	vsmcfibro	control
AGTCTCCCACGGTGAA-1	VSMC	vsmcfibro	control
AGTCTCCGTATGAAGT-1	RBC	NA	control
AGTTCGAAGGAGCAAA-1	Macrophages	NA	control
AGTTCGACACAAATAG-1	Endothelial	endo	control
ATACCGAAGGCTCACC-1	B-cells	NA	control
ATACCGACACGAGGTA-1	B-cells	NA	control
ATACCGATCCTGGTCT-1	VSMC	vsmcfibro	control
ATACCTTTCACGGGAA-1	Fibroblast	vsmcfibro	control
ATACTTCCACCTGCGA-1	T-cells	NA	control
ATACTTCCAGTAGAGC-1	Fibroblast	vsmcfibro	control
ATAGAGAAGCACACCC-1	Endothelial	endo	control
ATAGAGACACCGGTCA-1	B-cells	NA	control
ATAGAGACAGCAGATG-1	Fibroblast	vsmcfibro	control
ATAGAGATCCTACGGG-1	Endothelial	endo	control
ATAGGCTCAAGACTGG-1	Endothelial	endo	control
ATAGGCTCATTCTTCA-1	T-cells	NA	control
ATAGGCTTCCTACCAC-1	VSMC	vsmcfibro	control
ATATCCTCATGACAGG-1	RBC	NA	control
ATATCCTGTGTAGGAC-1	Fibroblast	vsmcfibro	control
ATCACAGCATCCGCGA-1	Fibroblast	vsmcfibro	control
ATCACAGGTTTCGCTC-1	Macrophages	NA	control
ATCACGATCCGCTTAC-1	Endothelial	endo	control
ATCACGATCGACATAC-1	Fibroblast	vsmcfibro	control
ATCACTTAGTTGGCTT-1	T-cells	NA	control
ATCACTTGTCCAGAAG-1	Endothelial	endo	control
ATCCACCCATAGATGA-1	T-cells	NA	control
ATCCATTCAATACGCT-1	B-cells	NA	control
ATCCCTGCACCGTGAC-1	T-cells	NA	control
ATCCGTCGTCTTACAG-1	T-cells	NA	control
ATCGATGGTAGCGAGT-1	T-cells	NA	control
ATCGCCTGTTCGTACA-1	Fibroblast	vsmcfibro	control
ATCGTAGCAACGGCCT-1	Fibroblast	vsmcfibro	control
ATCGTCCCACTGCGAC-1	T-cells	NA	control
ATCGTGATCCTACCGT-1	Macrophages	NA	control
ATCTTCAAGCAGAAAG-1	Fibroblast	vsmcfibro	control
ATCTTCACAACGTATC-1	B-cells	NA	control
ATCTTCACACAGCTGC-1	B-cells	NA	control
ATCTTCAGTTACGATC-1	T-cells	NA	control
ATGAAAGAGATACAGT-1	RBC	NA	control
ATGAAAGGTAACAGGC-1	Fibroblast	vsmcfibro	control
ATGAAAGGTTACCGTA-1	Fibroblast	vsmcfibro	control
ATGACCATCTGTCAGA-1	Fibroblast	vsmcfibro	control
ATGAGGGAGTAAGAGG-1	B-cells	NA	control
ATGAGGGCAGCGTAGA-1	RBC	NA	control
ATGAGTCCAAGGTCTT-1	VSMC	vsmcfibro	control
ATGATCGGTTCTCGTC-1	T-cells	NA	control
ATGCCTCAGTACAACA-1	Macrophages	NA	control
ATGCCTCCAAATACGA-1	Endothelial	endo	control
ATGCCTCCACAACGCC-1	RBC	NA	control
ATGCCTCGTTCAAGGG-1	Macrophages	NA	control
ATGGAGGTCTGACAGT-1	Fibroblast	vsmcfibro	control
ATGGGAGGTTACGGAG-1	RBC	NA	control
ATGGGTTGTGCAATGG-1	B-cells	NA	control
ATGTCTTCACTAGTAC-1	Fibroblast	vsmcfibro	control
ATGTCTTTCTCTATGT-1	B-cells	NA	control
ATTCAGGGTATTAAGG-1	Macrophages	NA	control
ATTCATCCACAAAGTA-1	T-cells	NA	control
ATTCATCTCTGATGGT-1	VSMC	vsmcfibro	control
ATTCCATAGTGTTGAA-1	Endothelial	endo	control
ATTCCCGAGCCTCGTG-1	Fibroblast	vsmcfibro	control
ATTCCCGGTTGATGTC-1	Fibroblast	vsmcfibro	control
ATTCCCGTCGACCACG-1	B-cells	NA	control
ATTCGTTTCCGTACGG-1	B-cells	NA	control
ATTCTACCAACATACC-1	B-cells	NA	control
ATTCTACGTTATGACC-1	Macrophages	NA	control
ATTCTACTCACTCGAA-1	Endothelial	endo	control
ATTCTACTCAGGTGTT-1	T-cells	NA	control
ATTCTTGTCTCCACTG-1	B-cells	NA	control
ATTGGGTCAGCTCCTT-1	Fibroblast	vsmcfibro	control
ATTGGGTCAGTTCACA-1	Endothelial	endo	control
ATTGGGTTCAAGCCTA-1	Endothelial	endo	control
ATTGTTCTCTCGTCAC-1	Endothelial	endo	control
ATTTACCTCCGTGTCT-1	T-cells	NA	control
ATTTCTGCAAAGGGCT-1	Fibroblast	vsmcfibro	control
CAAAGAATCTGACGCG-1	Fibroblast	vsmcfibro	control
CAACAACTCGGCCCAA-1	B-cells	NA	control
CAACAGTCAATCAAGA-1	Endothelial	endo	control
CAACAGTCAGGTTCCG-1	Macrophages	NA	control
CAACGGCAGGGATCGT-1	T-cells	NA	control
CAACGGCTCTATTTCG-1	Macrophages	NA	control
CAAGACTGTAATTAGG-1	T-cells	NA	control
CAAGACTGTAGGCTCC-1	Endothelial	endo	control
CAAGAGGCAAGACAAT-1	B-cells	NA	control
CAAGAGGCAATTCACG-1	T-cells	NA	control
CAAGAGGCATGGCTAT-1	B-cells	NA	control
CAAGCTACACTTGACA-1	Endothelial	endo	control
CAAGCTATCGGCTATA-1	B-cells	NA	control
CAAGGGAGTAACTTCG-1	Macrophages	NA	control
CAATACGCACTCCGGA-1	Macrophages	NA	control
CAATACGGTCGCGTTG-1	T-cells	NA	control
CAATACGTCGAGTGGA-1	T-cells	NA	control
CAATGACGTACTCCGG-1	Fibroblast	vsmcfibro	control
CAATGACGTTAGAAAC-1	B-cells	NA	control
CAATTTCTCACGTAGT-1	VSMC	vsmcfibro	control
CAATTTCTCGTTCAGA-1	B-cells	NA	control
CACAACACATGCTGCG-1	B-cells	NA	control
CACACAACAGTTACCA-1	RBC	NA	control
CACACAATCGGCTGTG-1	B-cells	NA	control
CACATGATCTTCACAT-1	Endothelial	endo	control
CACGTGGGTAGAGATT-1	T-cells	NA	control
CACGTTCAGCAGCACA-1	T-cells	NA	control
CACGTTCCAGCTGTAT-1	Fibroblast	vsmcfibro	control
CACTGGGCAAAGGCGT-1	RBC	NA	control
CACTGGGCACCAAAGG-1	Macrophages	NA	control
CACTGTCAGGACATCG-1	B-cells	NA	control
CACTGTCGTTGCGTAT-1	T-cells	NA	control
CACTTCGAGAAGTCAT-1	Fibroblast	vsmcfibro	control
CAGAGCCAGCATCCTA-1	VSMC	vsmcfibro	control
CAGAGCCCAGATCCAT-1	Fibroblast	vsmcfibro	control
CAGAGCCCATTATGCG-1	Fibroblast	vsmcfibro	control
CAGATACTCGACCAAT-1	T-cells	NA	control
CAGATCACAATGAAAC-1	Fibroblast	vsmcfibro	control
CAGCACGGTGGCTAGA-1	Fibroblast	vsmcfibro	control
CAGCAGCAGGGACACT-1	T-cells	NA	control
CAGCAGCAGGTACCTT-1	B-cells	NA	control
CAGCCAGCACAGTCCG-1	Macrophages	NA	control
CAGCCAGGTAGTATAG-1	Macrophages	NA	control
CAGCGTGTCCTCATAT-1	Fibroblast	vsmcfibro	control
CAGGCCAAGAGGTATT-1	T-cells	NA	control
CAGGCCAAGTGTTCCA-1	RBC	NA	control
CAGGGCTCACATGGTT-1	RBC	NA	control
CAGTTCCCAAAGAACT-1	RBC	NA	control
CATAAGCTCGGCATCG-1	B-cells	NA	control
CATAAGCTCTCGCAGG-1	Macrophages	NA	control
CATACAGTCGCGCCAA-1	B-cells	NA	control
CATACTTAGATGATTG-1	Endothelial	endo	control
CATACTTCAGTAGTGG-1	B-cells	NA	control
CATAGACTCCATCTCG-1	RBC	NA	control
CATCAAGCAGGCATTT-1	B-cells	NA	control
CATCCGTTCCGATCGG-1	Macrophages	NA	control
CATCGCTAGGCTTTCA-1	RBC	NA	control
CATCGTCAGGTAATCA-1	VSMC	vsmcfibro	control
CATCGTCAGTAGGGTC-1	Endothelial	endo	control
CATGAGTTCGATTTCT-1	Endothelial	endo	control
CATGCAACAAGCAATA-1	Endothelial	endo	control
CATGCCTCAAGCAGGT-1	Endothelial	endo	control
CATGCGGAGTACCGGA-1	Endothelial	endo	control
CATGCTCCAACCACAT-1	Macrophages	NA	control
CATGGATAGTTTGCTG-1	Fibroblast	vsmcfibro	control
CATGGATGTCCCTGAG-1	Fibroblast	vsmcfibro	control
CATGGTACAGTCGTTA-1	Endothelial	endo	control
CATGGTACATCGCTAA-1	T-cells	NA	control
CATTCATAGCGGTAAC-1	Endothelial	endo	control
CATTCATAGTGACCTT-1	RBC	NA	control
CATTCATCATCTGTTT-1	T-cells	NA	control
CATTCATCATTAAAGG-1	Endothelial	endo	control
CATTCTAGTCCAGCGT-1	Fibroblast	vsmcfibro	control
CATTCTAGTTAAGGGC-1	T-cells	NA	control
CATTGAGAGTATAACG-1	Macrophages	NA	control
CATTGAGCATAGGAGC-1	B-cells	NA	control
CATTGAGGTCATTGCA-1	T-cells	NA	control
CATTGCCTCGCCAATA-1	T-cells	NA	control
CATTGTTGTGTATTGC-1	B-cells	NA	control
CATTTCAGTAGCACGA-1	Fibroblast	vsmcfibro	control
CCAAGCGTCACTCCGT-1	T-cells	NA	control
CCAAGCGTCGATTTCT-1	Endothelial	endo	control
CCAATGACATGACTAC-1	B-cells	NA	control
CCAATTTCATACCAGT-1	RBC	NA	control
CCACAAAAGTGTACAA-1	B-cells	NA	control
CCACAAAGTCTCTCTG-1	B-cells	NA	control
CCACAAATCACACCCT-1	B-cells	NA	control
CCACACTCATCGCTAA-1	RBC	NA	control
CCACCATGTGTGTCCG-1	VSMC	vsmcfibro	control
CCACGTTCAATGCAGG-1	Fibroblast	vsmcfibro	control
CCACGTTCATTGCAAC-1	Fibroblast	vsmcfibro	control
CCACTTGTCACTTGTT-1	B-cells	NA	control
CCATAAGTCGTAACAC-1	Fibroblast	vsmcfibro	control
CCCATTGAGACAGCTG-1	T-cells	NA	control
CCCTAACAGTGTTGAA-1	B-cells	NA	control
CCCTAACGTCATGACT-1	B-cells	NA	control
CCCTCAAGTGCGACAA-1	RBC	NA	control
CCCTCTCAGAGAGCGG-1	B-cells	NA	control
CCCTTAGGTTACGTAC-1	B-cells	NA	control
CCGAACGGTGATGGCA-1	B-cells	NA	control
CCGATCTAGGGAGTTC-1	Macrophages	NA	control
CCGATCTTCGTTACCC-1	RBC	NA	control
CCGATGGTCGGAATTC-1	Fibroblast	vsmcfibro	control
CCGGGTAAGAGGGTCT-1	B-cells	NA	control
CCGGGTATCGGTGTAT-1	Fibroblast	vsmcfibro	control
CCGGTAGGTTGGACTT-1	Fibroblast	vsmcfibro	control
CCGGTGAAGTCTGGTT-1	B-cells	NA	control
CCTAACCAGATACATG-1	Endothelial	endo	control
CCTAACCTCAAGCCGC-1	T-cells	NA	control
CCTAAGAGTGAGTAGC-1	Endothelial	endo	control
CCTACGTGTAATCAAG-1	T-cells	NA	control
CCTACGTGTTCCGCTT-1	B-cells	NA	control
CCTATCGTCCCGAAAT-1	T-cells	NA	control
CCTCAACCAGGAGGAG-1	Macrophages	NA	control
CCTCAACGTCGAATGG-1	Endothelial	endo	control
CCTCAGTAGATGTAGT-1	Endothelial	endo	control
CCTCAGTAGGGTACGT-1	RBC	NA	control
CCTCAGTTCTCCTGTG-1	T-cells	NA	control
CCTCATGCATGTTCAG-1	VSMC	vsmcfibro	control
CCTCATGGTCCCAAAT-1	Macrophages	NA	control
CCTCCAATCTACCAGA-1	VSMC	vsmcfibro	control
CCTCCTCTCTTTCCGG-1	B-cells	NA	control
CCTCTCCAGACTACGG-1	RBC	NA	control
CCTCTCCGTCTAGTGT-1	Fibroblast	vsmcfibro	control
CCTCTCCGTTTGCCGG-1	Fibroblast	vsmcfibro	control
CCTCTCCTCGCCAGAC-1	VSMC	vsmcfibro	control
CCTGCATAGCAGGCTA-1	Endothelial	endo	control
CCTTCAGGTAACGGTG-1	Endothelial	endo	control
CGAAGGACATCCAATG-1	Fibroblast	vsmcfibro	control
CGAAGTTCATCCAATG-1	RBC	NA	control
CGAATTGGTCTTGAGT-1	Macrophages	NA	control
CGAGGAACAAGAGAGA-1	VSMC	vsmcfibro	control
CGAGGCTAGTCATTGC-1	B-cells	NA	control
CGAGGCTCACCTGCGA-1	T-cells	NA	control
CGAGGCTTCGCGTTTC-1	Fibroblast	vsmcfibro	control
CGAGTGCAGATGTTGA-1	B-cells	NA	control
CGAGTTAAGTGCGACA-1	B-cells	NA	control
CGAGTTAGTAGTGGCA-1	Endothelial	endo	control
CGATCGGGTGGCGTAA-1	Endothelial	endo	control
CGATGCGGTGGAGAAA-1	RBC	NA	control
CGATGGCGTATGCGGA-1	RBC	NA	control
CGATGGCTCCGCATAA-1	Fibroblast	vsmcfibro	control
CGCATAAAGGAACTCG-1	T-cells	NA	control
CGCATAAGTTCACGAT-1	T-cells	NA	control
CGCATGGCAAAGACGC-1	RBC	NA	control
CGCATGGGTAACGTTC-1	Fibroblast	vsmcfibro	control
CGCCAGAAGAGGTATT-1	Fibroblast	vsmcfibro	control
CGCCAGAAGGGACACT-1	T-cells	NA	control
CGCCAGACAGGTTCCG-1	RBC	NA	control
CGCGTGATCTGGTCAA-1	RBC	NA	control
CGGAACCGTGCACGCT-1	RBC	NA	control
CGGAATTAGAGCATAT-1	B-cells	NA	control
CGGAATTCAGAATCGG-1	RBC	NA	control
CGGACACAGCACTCTA-1	T-cells	NA	control
CGGCAGTAGAATTTGG-1	Fibroblast	vsmcfibro	control
CGGCAGTCATCCTAAG-1	T-cells	NA	control
CGGCAGTGTAAGCAAT-1	RBC	NA	control
CGGGACTAGAAGTATC-1	Fibroblast	vsmcfibro	control
CGGGACTTCGATGCAT-1	Endothelial	endo	control
CGGGTCACATATCTGG-1	Fibroblast	vsmcfibro	control
CGGGTGTGTATTTCTC-1	Endothelial	endo	control
CGTAAGTGTTCTCTCG-1	T-cells	NA	control
CGTAAGTTCGCAGTGC-1	Fibroblast	vsmcfibro	control
CGTAATGGTCGGCTAC-1	Endothelial	endo	control
CGTAATGTCGTCAAAC-1	Endothelial	endo	control
CGTCAAACAGGCCCTA-1	RBC	NA	control
CGTCAAAGTCGTTATG-1	T-cells	NA	control
CGTCAAATCATCAGTG-1	T-cells	NA	control
CGTGAATTCTCCGTGT-1	Fibroblast	vsmcfibro	control
CGTGATAAGTAACCGG-1	Fibroblast	vsmcfibro	control
CGTGATATCCTTTGAT-1	T-cells	NA	control
CGTGCTTCACTGATTG-1	Fibroblast	vsmcfibro	control
CGTGTCTTCACCGGTG-1	Endothelial	endo	control
CGTGTCTTCTAGCCAA-1	T-cells	NA	control
CGTTAGAAGACGACGT-1	Fibroblast	vsmcfibro	control
CGTTCTGAGGTCCCTG-1	Endothelial	endo	control
CTAACCCAGCCAAGTG-1	RBC	NA	control
CTAACCCAGTATCTGC-1	Macrophages	NA	control
CTACATTTCGGCCTTT-1	B-cells	NA	control
CTACCTGGTGGCCTCA-1	Fibroblast	vsmcfibro	control
CTACTATCAAGCAGGT-1	Fibroblast	vsmcfibro	control
CTACTATTCAAACCTG-1	Macrophages	NA	control
CTATAGGAGCTGGCTC-1	T-cells	NA	control
CTATCCGTCGAGATGG-1	B-cells	NA	control
CTATCTAAGATGTTAG-1	RBC	NA	control
CTCAACCCAGGCTCTG-1	Fibroblast	vsmcfibro	control
CTCAAGAAGTGTTCCA-1	Endothelial	endo	control
CTCAAGATCACTGGTA-1	Fibroblast	vsmcfibro	control
CTCAATTGTCTCAGAT-1	T-cells	NA	control
CTCACTGAGAAACTGT-1	RBC	NA	control
CTCACTGGTCTGTGCG-1	RBC	NA	control
CTCAGAACACGGAAGT-1	RBC	NA	control
CTCAGGGAGTAAGACT-1	Fibroblast	vsmcfibro	control
CTCAGTCAGATGTTGA-1	Endothelial	endo	control
CTCAGTCAGGGTCTTT-1	Fibroblast	vsmcfibro	control
CTCAGTCTCTAGAACC-1	T-cells	NA	control
CTCATCGAGAGCGACT-1	Fibroblast	vsmcfibro	control
CTCATGCAGTGCTAGG-1	B-cells	NA	control
CTCATTACATCACGGC-1	T-cells	NA	control
CTCCAACCACCTAAAC-1	Endothelial	endo	control
CTCCAACGTATGTCTG-1	RBC	NA	control
CTCCACAAGCGCAATG-1	T-cells	NA	control
CTCCACAAGGAACGTC-1	Endothelial	endo	control
CTCCACATCCATAAGC-1	Endothelial	endo	control
CTCCATGAGCTTCGTA-1	Macrophages	NA	control
CTCCATGAGGTTGCCC-1	RBC	NA	control
CTCCATGGTGGATTTC-1	Macrophages	NA	control
CTCCATGGTGGTTCTA-1	Endothelial	endo	control
CTCCCTCAGTGCAGCA-1	B-cells	NA	control
CTCCCTCGTCCAGCAC-1	T-cells	NA	control
CTCCGATCAACGCATT-1	RBC	NA	control
CTCCGATGTAGCACAG-1	Endothelial	endo	control
CTCCGATTCTCATTAC-1	RBC	NA	control
CTCGAGGCAGGTCCGT-1	Endothelial	endo	control
CTCTCGACACGAGGAT-1	Fibroblast	vsmcfibro	control
CTGAATGAGTTCACTG-1	T-cells	NA	control
CTGCAGGAGTCATAGA-1	T-cells	NA	control
CTGCATCAGCGTGCCT-1	Macrophages	NA	control
CTGCCATAGACAACTA-1	VSMC	vsmcfibro	control
CTGCCTACAAACTAGA-1	T-cells	NA	control
CTGCGAGTCTAGGCAT-1	RBC	NA	control
CTGGACGGTGGTCTTA-1	Macrophages	NA	control
CTGGTCTCAACCCTAA-1	B-cells	NA	control
CTGTACCGTGATTGGG-1	Macrophages	NA	control
CTGTACCTCGTCGACG-1	RBC	NA	control
CTGTGAAAGCGATGCA-1	Endothelial	endo	control
CTGTGAAAGGCGCTTC-1	T-cells	NA	control
CTGTGAACAATCGCAT-1	Fibroblast	vsmcfibro	control
CTGTGAATCGGCAGTC-1	T-cells	NA	control
CTTACCGAGAACGCGT-1	Fibroblast	vsmcfibro	control
CTTACCGCAACCCTAA-1	RBC	NA	control
CTTACCGCAGCTGTTA-1	B-cells	NA	control
CTTACCGGTTTAGACC-1	Fibroblast	vsmcfibro	control
CTTCAATAGTAAAGCT-1	Macrophages	NA	control
CTTCCGAGTATTCCGA-1	RBC	NA	control
CTTCCGATCGGACTGC-1	T-cells	NA	control
CTTCCTTGTTCGTACA-1	Fibroblast	vsmcfibro	control
CTTCGGTTCTGTGCAA-1	VSMC	vsmcfibro	control
CTTCTAACACAGCATT-1	Endothelial	endo	control
CTTCTAAGTCACTTAG-1	T-cells	NA	control
CTTCTAATCTTCGCTG-1	Macrophages	NA	control
CTTCTCTAGTGGACGT-1	Fibroblast	vsmcfibro	control
CTTGAGAGTCAACCAT-1	B-cells	NA	control
CTTGATTTCGTTAGTG-1	Endothelial	endo	control
CTTTCAAAGGGCCCTT-1	RBC	NA	control
CTTTCGGCACAGTCCG-1	Fibroblast	vsmcfibro	control
CTTTCGGTCATCACCC-1	VSMC	vsmcfibro	control
GAAACCTGTCACTAGT-1	T-cells	NA	control
GAAATGAAGCAACCAG-1	T-cells	NA	control
GAACACTTCCACTTCG-1	Fibroblast	vsmcfibro	control
GAACTGTAGGTCCGAA-1	Macrophages	NA	control
GAACTGTTCCATCTCG-1	B-cells	NA	control
GAAGCCCCATCAGCGC-1	T-cells	NA	control
GAAGCGAAGTCGGCAA-1	B-cells	NA	control
GAAGCGACACCCTTGT-1	Fibroblast	vsmcfibro	control
GAAGGGTAGCCTGTCG-1	Fibroblast	vsmcfibro	control
GAAGGGTCAGCGAACA-1	B-cells	NA	control
GAATAGATCCGAGGCT-1	Macrophages	NA	control
GACACGCCATCGCTCT-1	T-cells	NA	control
GACAGCCCACACACGC-1	B-cells	NA	control
GACAGCCCATTCACCC-1	RBC	NA	control
GACAGCCTCCCGTTGT-1	Endothelial	endo	control
GACCCTTAGTAGCTCT-1	RBC	NA	control
GACGCTGAGACAAGCC-1	B-cells	NA	control
GACGCTGCACCGTGAC-1	T-cells	NA	control
GACGTTAAGATCGCCC-1	Macrophages	NA	control
GACGTTACAACCGCCA-1	B-cells	NA	control
GACGTTACAGATTAAG-1	Fibroblast	vsmcfibro	control
GACTCAAGTAGGTCAG-1	Fibroblast	vsmcfibro	control
GACTCAAGTAGTTACC-1	RBC	NA	control
GACTCTCGTATACCTG-1	T-cells	NA	control
GAGAAATAGAAACTGT-1	VSMC	vsmcfibro	control
GAGAAATAGTCAACAA-1	Fibroblast	vsmcfibro	control
GAGACCCTCTGAGTCA-1	Fibroblast	vsmcfibro	control
GAGACTTCAAGTGCAG-1	Fibroblast	vsmcfibro	control
GAGACTTCACTTGTCC-1	Macrophages	NA	control
GAGACTTCATCCGTGG-1	Fibroblast	vsmcfibro	control
GAGATGGAGCTACTAC-1	Fibroblast	vsmcfibro	control
GAGCCTGAGGTTCCAT-1	Macrophages	NA	control
GAGCTGCCACCTAAAC-1	Fibroblast	vsmcfibro	control
GAGGCCTTCAGCCTTC-1	VSMC	vsmcfibro	control
GAGTCATCACTCCGAG-1	Fibroblast	vsmcfibro	control
GAGTCATGTCCATAGT-1	Endothelial	endo	control
GAGTCTACATCATCCC-1	Endothelial	endo	control
GAGTCTAGTACGCTAT-1	Endothelial	endo	control
GAGTGTTGTGGGTATG-1	T-cells	NA	control
GAGTGTTTCTTAGCCC-1	T-cells	NA	control
GAGTTACGTGGACTGA-1	Endothelial	endo	control
GAGTTGTCACGCAAAG-1	Endothelial	endo	control
GAGTTTGGTCCCAAAT-1	RBC	NA	control
GAGTTTGTCGCCAGAC-1	Endothelial	endo	control
GATAGAAAGCCTCAGC-1	T-cells	NA	control
GATAGAATCAGTCATG-1	Macrophages	NA	control
GATCACATCCACACAA-1	Fibroblast	vsmcfibro	control
GATCATGAGTTGCCCG-1	B-cells	NA	control
GATCCCTAGTAAGGGA-1	Endothelial	endo	control
GATCCCTCAACCGTGC-1	T-cells	NA	control
GATGAGGGTTCAATCG-1	VSMC	vsmcfibro	control
GATGATCCATAGGTTC-1	Macrophages	NA	control
GATGCTAAGCAGGGAG-1	Endothelial	endo	control
GATGCTAAGGCGATAC-1	Macrophages	NA	control
GATGCTACATCATTTC-1	Endothelial	endo	control
GATGCTAGTGTGCCTG-1	Macrophages	NA	control
GATGCTATCTATTGTC-1	Neuron	NA	control
GATGGAGAGCAATAAC-1	RBC	NA	control
GATGGAGCATGGCCAC-1	Fibroblast	vsmcfibro	control
GATGTTGTCATTGGTG-1	T-cells	NA	control
GATTCGAGTAGTCCTA-1	Endothelial	endo	control
GATTCTTCAATAGTAG-1	B-cells	NA	control
GATTCTTGTCAAGCGA-1	T-cells	NA	control
GATTCTTGTTACTCAG-1	Fibroblast	vsmcfibro	control
GATTCTTTCAAGTGTC-1	RBC	NA	control
GATTGGTAGAGGACTC-1	Fibroblast	vsmcfibro	control
GCAACATAGGTTCTAC-1	T-cells	NA	control
GCAACATTCATATGGC-1	Fibroblast	vsmcfibro	control
GCAACATTCGTTATCT-1	T-cells	NA	control
GCACATAGTGTTTGCA-1	Macrophages	NA	control
GCACGGTAGGACTAAT-1	RBC	NA	control
GCACGTGAGGTAAGGA-1	Fibroblast	vsmcfibro	control
GCACGTGGTGTGATGG-1	Fibroblast	vsmcfibro	control
GCACTAAAGTAACGAT-1	B-cells	NA	control
GCACTAACAGAAGCGT-1	B-cells	NA	control
GCAGCTGAGGAGTATT-1	T-cells	NA	control
GCAGCTGCACCCATAA-1	Endothelial	endo	control
GCAGCTGGTAACGTTC-1	Fibroblast	vsmcfibro	control
GCAGCTGTCGCGCTGA-1	Macrophages	NA	control
GCAGTTACATTATGCG-1	Endothelial	endo	control
GCAGTTATCTATCGCC-1	Endothelial	endo	control
GCATCGGAGGTTGCCC-1	Macrophages	NA	control
GCATCGGAGTTTCTTC-1	RBC	NA	control
GCATTAGGTACAGTTC-1	Fibroblast	vsmcfibro	control
GCCAACGTCAAGGTGG-1	B-cells	NA	control
GCCAGCATCGGAAGGT-1	B-cells	NA	control
GCCAGTGCATCGTCCT-1	B-cells	NA	control
GCCCAGAAGCACCGAA-1	Fibroblast	vsmcfibro	control
GCCCAGATCTCTAAGG-1	T-cells	NA	control
GCCCGAACATAGGTAA-1	Endothelial	endo	control
GCCGATGAGTCGGCCT-1	T-cells	NA	control
GCGAGAACAAGTATAG-1	T-cells	NA	control
GCGAGAAGTCTGATAC-1	Fibroblast	vsmcfibro	control
GCGAGAAGTCTTTCAT-1	B-cells	NA	control
GCGAGAATCGAACTCA-1	Fibroblast	vsmcfibro	control
GCGATCGAGGCGTTAG-1	RBC	NA	control
GCGATCGCATCGCCTT-1	Endothelial	endo	control
GCGATCGTCAACGTGT-1	T-cells	NA	control
GCGGAAAGTTCAGTAC-1	Fibroblast	vsmcfibro	control
GCGGAAATCCCGTTGT-1	Macrophages	NA	control
GCGGATCCAGGCGTTC-1	Endothelial	endo	control
GCTACCTGTAGAGCTG-1	T-cells	NA	control
GCTACCTTCATGCCAA-1	Macrophages	NA	control
GCTCAAAGTTAGGAGC-1	RBC	NA	control
GCTCAAATCCAATCTT-1	Fibroblast	vsmcfibro	control
GCTGGGTGTAATGCGG-1	Endothelial	endo	control
GCTTCACCAGGATGAC-1	RBC	NA	control
GGAACCCAGGAGTATT-1	T-cells	NA	control
GGAACCCCACTGTTCC-1	Endothelial	endo	control
GGAACCCCATTGCTTT-1	Fibroblast	vsmcfibro	control
GGAATCTCACATGGTT-1	B-cells	NA	control
GGAATCTCAGGACTTT-1	Macrophages	NA	control
GGAATCTCATCCGATA-1	Fibroblast	vsmcfibro	control
GGAATCTGTGTCTTGA-1	T-cells	NA	control
GGACGTCAGCATTTGC-1	Endothelial	endo	control
GGACGTCAGGATTCCT-1	Fibroblast	vsmcfibro	control
GGACGTCCACTTGACA-1	Macrophages	NA	control
GGAGATGCACGCGCTA-1	Endothelial	endo	control
GGAGATGTCGACACTA-1	Endothelial	endo	control
GGAGGATAGGGCTTCC-1	Fibroblast	vsmcfibro	control
GGAGGATTCATACGAC-1	Endothelial	endo	control
GGAGGTATCGAGTCTA-1	T-cells	NA	control
GGAGGTATCGGCATCG-1	Fibroblast	vsmcfibro	control
GGATCTAGTTCGGTCG-1	Endothelial	endo	control
GGATGTTAGCTTCATG-1	Fibroblast	vsmcfibro	control
GGATGTTTCATGCATG-1	Fibroblast	vsmcfibro	control
GGCGTCACAGCTGAGA-1	VSMC	vsmcfibro	control
GGCTTGGAGTAGTCTC-1	Fibroblast	vsmcfibro	control
GGCTTTCCACGTTGGC-1	Endothelial	endo	control
GGCTTTCTCGACCAAT-1	RBC	NA	control
GGCTTTCTCTTACGGA-1	Fibroblast	vsmcfibro	control
GGGACAATCCTACCGT-1	Fibroblast	vsmcfibro	control
GGGACTCAGGAGAGGC-1	T-cells	NA	control
GGGAGATAGGCGCTCT-1	Endothelial	endo	control
GGGAGTAGTCTGCGCA-1	Macrophages	NA	control
GGGAGTATCGAACCAT-1	Endothelial	endo	control
GGGATCCGTCTACGTA-1	B-cells	NA	control
GGGATGATCGCTATTT-1	Fibroblast	vsmcfibro	control
GGGCTCAAGGATTTGA-1	RBC	NA	control
GGGCTCAGTGATCATC-1	Endothelial	endo	control
GGGCTCAGTGCATGAG-1	Fibroblast	vsmcfibro	control
GGGTAGACACAAGTGG-1	Endothelial	endo	control
GGGTAGATCAAGCTTG-1	RBC	NA	control
GGGTCACCAAATGGAT-1	Endothelial	endo	control
GGGTCTGGTCTGTGGC-1	T-cells	NA	control
GGGTGAACAATATCCG-1	Endothelial	endo	control
GGGTGAACACTGGACC-1	Macrophages	NA	control
GGGTGTCAGCTAGAAT-1	Fibroblast	vsmcfibro	control
GGTAACTAGTAAGAGG-1	Endothelial	endo	control
GGTAATCTCCGGTAAT-1	Macrophages	NA	control
GGTAGAGCAAAGCACG-1	Fibroblast	vsmcfibro	control
GGTCTGGTCCGTGACG-1	Fibroblast	vsmcfibro	control
GGTGATTAGCGTATGG-1	T-cells	NA	control
GGTGGCTTCATCACTT-1	Fibroblast	vsmcfibro	control
GGTGTCGGTCCACTTC-1	Endothelial	endo	control
GGTGTTAAGAGGTATT-1	VSMC	vsmcfibro	control
GGTGTTACATGGGTTT-1	Fibroblast	vsmcfibro	control
GGTTAACGTTTGACAC-1	Endothelial	endo	control
GGTTCTCAGTGCACAG-1	Macrophages	NA	control
GGTTCTCGTGGTCTCG-1	B-cells	NA	control
GGTTGTACATGATCTG-1	T-cells	NA	control
GTAACCAGTTACGTAC-1	Macrophages	NA	control
GTAACCATCTTCGCTG-1	Fibroblast	vsmcfibro	control
GTAATCGTCAGCTTGA-1	T-cells	NA	control
GTAATCGTCTTCTGTA-1	T-cells	NA	control
GTAATGCAGGAGAGGC-1	T-cells	NA	control
GTAATGCGTTCTTGTT-1	VSMC	vsmcfibro	control
GTACAACAGTTAGTAG-1	Macrophages	NA	control
GTACAGTTCCATGCAA-1	Fibroblast	vsmcfibro	control
GTAGAAAGTGCGCTCA-1	T-cells	NA	control
GTAGATCAGTAGCCAG-1	T-cells	NA	control
GTAGATCTCCGAGGCT-1	Endothelial	endo	control
GTAGATCTCGTTTACT-1	Fibroblast	vsmcfibro	control
GTAGGAGAGATTCGCT-1	Endothelial	endo	control
GTAGGTTAGGTTGAGC-1	Fibroblast	vsmcfibro	control
GTAGGTTCAACGACAG-1	Fibroblast	vsmcfibro	control
GTAGTACGTACCGCGT-1	Endothelial	endo	control
GTAGTACGTTAGAAAC-1	Fibroblast	vsmcfibro	control
GTATTGGAGCGTTCAT-1	RBC	NA	control
GTATTGGCATGTGGTT-1	Fibroblast	vsmcfibro	control
GTATTGGGTATCTCTT-1	T-cells	NA	control
GTATTTCTCGTGACTA-1	Endothelial	endo	control
GTCAAACCAAGTCATC-1	Fibroblast	vsmcfibro	control
GTCAAACGTTGCATAC-1	Endothelial	endo	control
GTCAAACTCCGACGGT-1	RBC	NA	control
GTCACGGAGAATACAC-1	Endothelial	endo	control
GTCACGGCACAATGTC-1	RBC	NA	control
GTCACGGGTGCGAACA-1	RBC	NA	control
GTCACGGTCCGCACTT-1	T-cells	NA	control
GTCACGGTCCTGGCTT-1	RBC	NA	control
GTCACTCAGCGGATCA-1	Fibroblast	vsmcfibro	control
GTCATCCAGATTGCGG-1	Fibroblast	vsmcfibro	control
GTCATCCAGTAGCAAT-1	Fibroblast	vsmcfibro	control
GTCCACTAGGATATGT-1	Fibroblast	vsmcfibro	control
GTCCACTTCAGCCTTC-1	B-cells	NA	control
GTCCCATAGCAATTCC-1	B-cells	NA	control
GTCGAATAGGAAGTCC-1	Endothelial	endo	control
GTCGAATCAGGGCTTC-1	Endothelial	endo	control
GTCGCGAAGGTTCCAT-1	T-cells	NA	control
GTCGCGAGTAGAATAC-1	Neuron	NA	control
GTCGCGATCGCTATTT-1	Fibroblast	vsmcfibro	control
GTCGTAAGTCCTCATC-1	B-cells	NA	control
GTCGTAAGTGCTCTTC-1	Endothelial	endo	control
GTCGTTCGTACAGAGC-1	RBC	NA	control
GTCGTTCGTCAACCTA-1	B-cells	NA	control
GTCGTTCTCAGAGTTC-1	Fibroblast	vsmcfibro	control
GTCTACCAGTGTTCAC-1	T-cells	NA	control
GTCTACCCATTCCTAT-1	Fibroblast	vsmcfibro	control
GTCTACCTCAGTCCGG-1	T-cells	NA	control
GTCTACCTCGAATCCA-1	B-cells	NA	control
GTCTAGATCTGCGGCA-1	Macrophages	NA	control
GTCTCACCATGACTGT-1	Endothelial	endo	control
GTCTTTACACGCTATA-1	Endothelial	endo	control
GTGACGCTCTGCATGA-1	T-cells	NA	control
GTGAGCCTCCATAGAC-1	B-cells	NA	control
GTGAGGAGTCCCGGTA-1	T-cells	NA	control
GTGAGGATCGCGATCG-1	Endothelial	endo	control
GTGAGGATCTGCGGCA-1	Fibroblast	vsmcfibro	control
GTGAGTTGTCCATAGT-1	T-cells	NA	control
GTGCAGCCAAGTGTCT-1	Macrophages	NA	control
GTGCAGCGTGTTACAC-1	Fibroblast	vsmcfibro	control
GTGCGTGAGGCCTTCG-1	T-cells	NA	control
GTGCTGGAGCGCCGTT-1	Fibroblast	vsmcfibro	control
GTGCTTCAGACATGCG-1	B-cells	NA	control
GTGCTTCCACCCTGAG-1	Fibroblast	vsmcfibro	control
GTGCTTCTCTGAGGCC-1	Endothelial	endo	control
GTGGAAGCAGCTTTCC-1	Fibroblast	vsmcfibro	control
GTGGAGACAAAGGCGT-1	VSMC	vsmcfibro	control
GTGGAGACAGAGTGAC-1	T-cells	NA	control
GTGGCGTTCCTAAACG-1	B-cells	NA	control
GTGGGAATCCTTATAC-1	B-cells	NA	control
GTGGGAATCGTAACAC-1	Macrophages	NA	control
GTGTAACAGCGTGTCC-1	Fibroblast	vsmcfibro	control
GTGTAACTCCAAACCA-1	RBC	NA	control
GTGTCCTTCGCTGATA-1	Fibroblast	vsmcfibro	control
GTGTGATAGACCATGG-1	Macrophages	NA	control
GTGTGGCGTAGTCTTG-1	B-cells	NA	control
GTGTTAGCAGATTAAG-1	Endothelial	endo	control
GTGTTAGCAGTAACCT-1	Fibroblast	vsmcfibro	control
GTTACAGGTCGACTGC-1	B-cells	NA	control
GTTACGAAGGTACAGC-1	Endothelial	endo	control
GTTACGAAGTACAACA-1	Endothelial	endo	control
GTTACGATCACTTATC-1	RBC	NA	control
GTTAGACGTATTGACC-1	Fibroblast	vsmcfibro	control
GTTAGTGCAATAACCC-1	RBC	NA	control
GTTAGTGCACAAATAG-1	B-cells	NA	control
GTTAGTGGTAAGCAAT-1	Macrophages	NA	control
GTTAGTGGTCATATGC-1	Macrophages	NA	control
GTTATGGGTCTGTCAA-1	Fibroblast	vsmcfibro	control
GTTCGCTCACGAGAAC-1	Endothelial	endo	control
GTTCGCTCAGGATTCT-1	B-cells	NA	control
GTTGAACAGAGGATCC-1	Macrophages	NA	control
GTTGAACAGCACCGTC-1	Endothelial	endo	control
GTTGCTCAGGCTTCCG-1	VSMC	vsmcfibro	control
GTTGCTCGTTTCTATC-1	RBC	NA	control
GTTGTAGCAAGTGCAG-1	VSMC	vsmcfibro	control
GTTGTCCAGGTTTACC-1	T-cells	NA	control
GTTGTCCCACATATGC-1	RBC	NA	control
GTTGTGAAGGGAACAA-1	B-cells	NA	control
GTTTACTGTGCATGTT-1	Fibroblast	vsmcfibro	control
GTTTACTTCACCTCTG-1	T-cells	NA	control
GTTTGGATCGTGCACG-1	Fibroblast	vsmcfibro	control
TAACACGAGGAACGTC-1	VSMC	vsmcfibro	control
TAACACGGTTTGGCTA-1	T-cells	NA	control
TAAGCACCAAGACTGG-1	RBC	NA	control
TAAGTCGCAACTGCTA-1	T-cells	NA	control
TAAGTCGCACCCTTGT-1	Endothelial	endo	control
TAAGTCGCATGAAAGT-1	Endothelial	endo	control
TAAGTCGGTAGAATAC-1	VSMC	vsmcfibro	control
TAATTCCAGTCTAGCT-1	Endothelial	endo	control
TAATTCCCATATCGGT-1	B-cells	NA	control
TAATTCCTCGTGTCAA-1	Fibroblast	vsmcfibro	control
TACACCCGTACAGTCT-1	B-cells	NA	control
TACACCCGTATGGTTC-1	RBC	NA	control
TACACCCTCCGATAGT-1	RBC	NA	control
TACAGGTCAATCGAAA-1	Fibroblast	vsmcfibro	control
TACATTCCAAAGAGTT-1	Macrophages	NA	control
TACCCACCACTCCTGT-1	T-cells	NA	control
TACCCGTAGCGCATCC-1	B-cells	NA	control
TACCCGTCACTCACTC-1	Neuron	NA	control
TACCGAAGTCCCGGTA-1	Fibroblast	vsmcfibro	control
TACCGGGAGTACTGTC-1	RBC	NA	control
TACCTGCCACATGTTG-1	Fibroblast	vsmcfibro	control
TACGCTCAGTCGTCTA-1	Fibroblast	vsmcfibro	control
TACGCTCGTACTAAGA-1	Fibroblast	vsmcfibro	control
TACGCTCGTTGGGCCT-1	Fibroblast	vsmcfibro	control
TACGGGCTCGTCTCAC-1	B-cells	NA	control
TACGGTAGTGAGTAGC-1	Endothelial	endo	control
TACGTCCAGAAACCCG-1	Endothelial	endo	control
TACTGCCGTTGTTGAC-1	Endothelial	endo	control
TACTGCCTCGGTTAGT-1	Macrophages	NA	control
TACTTCAAGTCGGGAT-1	Fibroblast	vsmcfibro	control
TACTTGTAGACGGATC-1	Fibroblast	vsmcfibro	control
TAGACTGGTGCCTAAT-1	B-cells	NA	control
TAGATCGGTCGATTAC-1	T-cells	NA	control
TAGGAGGGTGTGACCC-1	Fibroblast	vsmcfibro	control
TAGGAGGGTTTCACTT-1	Fibroblast	vsmcfibro	control
TAGGGTTAGGTATCTC-1	RBC	NA	control
TAGGGTTCAGTTACCA-1	Fibroblast	vsmcfibro	control
TAGGTTGTCCGAAGGA-1	B-cells	NA	control
TAGTGCACAAGAGGCT-1	Fibroblast	vsmcfibro	control
TATACCTGTACAGAAT-1	Endothelial	endo	control
TATCAGGTCGAGCCAC-1	T-cells	NA	control
TATCCTACAACTGATC-1	RBC	NA	control
TATCCTATCCTGTAAG-1	Endothelial	endo	control
TATCTGTAGGAACGAA-1	Macrophages	NA	control
TATCTGTCATCAGTCA-1	Endothelial	endo	control
TATCTTGAGGCTCAAG-1	Macrophages	NA	control
TATCTTGTCCGACAGC-1	T-cells	NA	control
TATTCCATCTAAGGAA-1	Endothelial	endo	control
TATTGCTTCTGAGGCC-1	B-cells	NA	control
TATTTCGCACCCTGTT-1	T-cells	NA	control
TCAAGACCAAGACCTT-1	VSMC	vsmcfibro	control
TCAATCTTCTCGCTCA-1	Fibroblast	vsmcfibro	control
TCACAAGGTACAGAGC-1	RBC	NA	control
TCACGCTTCGGCTCTT-1	Fibroblast	vsmcfibro	control
TCACGGGAGTCTTCGA-1	VSMC	vsmcfibro	control
TCACGGGAGTGTAGAT-1	B-cells	NA	control
TCACGGGCATCGGTTA-1	VSMC	vsmcfibro	control
TCACGGGGTACGAGCA-1	T-cells	NA	control
TCACGGGTCTGAGCAT-1	RBC	NA	control
TCACTCGCAGTAGTTC-1	Endothelial	endo	control
TCAGCCTCACGCTATA-1	VSMC	vsmcfibro	control
TCAGCCTGTAGGCAGT-1	Fibroblast	vsmcfibro	control
TCAGCCTGTGGTTCTA-1	B-cells	NA	control
TCAGCCTTCCGTTGGG-1	B-cells	NA	control
TCAGTCCAGGCATGCA-1	Endothelial	endo	control
TCAGTCCCAGACGCTC-1	RBC	NA	control
TCAGTCCCAGCTTCGG-1	VSMC	vsmcfibro	control
TCAGTGAAGTAGAGTT-1	T-cells	NA	control
TCAGTGACACGTCGGT-1	Neuron	NA	control
TCATACTGTCTCACAA-1	T-cells	NA	control
TCATACTTCTATTCGT-1	RBC	NA	control
TCATCCGGTAGGCTGA-1	T-cells	NA	control
TCATGCCGTCTGATCA-1	T-cells	NA	control
TCATGCCTCGAATGCT-1	VSMC	vsmcfibro	control
TCATTACAGCGGTATG-1	B-cells	NA	control
TCATTGTGTGGAAATT-1	RBC	NA	control
TCATTGTTCAGCACCG-1	Macrophages	NA	control
TCCACGTCACTTGACA-1	Fibroblast	vsmcfibro	control
TCCAGAACAACCAATC-1	Endothelial	endo	control
TCCATCGGTCCCTCAT-1	Unknown	NA	control
TCCATCGGTGGTAACG-1	Macrophages	NA	control
TCCCATGGTCTTCATT-1	T-cells	NA	control
TCCCATGTCCTGGTCT-1	T-cells	NA	control
TCCGATCCACTTTATC-1	B-cells	NA	control
TCCGATCGTATGCAAA-1	Endothelial	endo	control
TCCGGGATCTACCACC-1	B-cells	NA	control
TCCGTGTCACCGTGGT-1	Macrophages	NA	control
TCCGTGTCAGGGACTA-1	VSMC	vsmcfibro	control
TCCGTGTGTTCGTACA-1	B-cells	NA	control
TCCTAATAGTTACGGG-1	T-cells	NA	control
TCCTCCCAGTACCATC-1	Macrophages	NA	control
TCCTCCCAGTAGACCG-1	VSMC	vsmcfibro	control
TCCTCCCCACCCTTAC-1	Fibroblast	vsmcfibro	control
TCCTCTTCAAAGCTAA-1	Macrophages	NA	control
TCCTGCAAGATGACCG-1	Endothelial	endo	control
TCCTGCATCCATACTT-1	Fibroblast	vsmcfibro	control
TCCTGCATCCTAACAG-1	RBC	NA	control
TCCTTCTAGCAATTAG-1	B-cells	NA	control
TCCTTCTAGGTCATTC-1	B-cells	NA	control
TCCTTCTAGTCTACCA-1	VSMC	vsmcfibro	control
TCCTTCTCACAGTGAG-1	Endothelial	endo	control
TCCTTTCAGTTCGGTT-1	RBC	NA	control
TCGAACAGTTTGAACC-1	Fibroblast	vsmcfibro	control
TCGAAGTAGCAGGCAT-1	Fibroblast	vsmcfibro	control
TCGAAGTAGTCATACC-1	RBC	NA	control
TCGAAGTAGTGTTGAA-1	Endothelial	endo	control
TCGAAGTCAGACAAAT-1	Macrophages	NA	control
TCGAAGTTCCACACAA-1	Endothelial	endo	control
TCGACCTAGGTCCAGA-1	B-cells	NA	control
TCGACCTCAATCCAGT-1	Fibroblast	vsmcfibro	control
TCGACGGAGCATGTTC-1	B-cells	NA	control
TCGATTTAGTGGATTA-1	Fibroblast	vsmcfibro	control
TCGCTCAGTAGGTAGC-1	B-cells	NA	control
TCGCTTGTCTATGCCC-1	B-cells	NA	control
TCGGATAAGAAAGCGA-1	Fibroblast	vsmcfibro	control
TCGGATACATATCTGG-1	Endothelial	endo	control
TCGGGCAGTCGTGCCA-1	Fibroblast	vsmcfibro	control
TCGGGTGTCGCACGAC-1	T-cells	NA	control
TCGGGTGTCTTGATTC-1	RBC	NA	control
TCGGTCTGTATACAGA-1	Fibroblast	vsmcfibro	control
TCGTAGAAGCCTGTGC-1	Fibroblast	vsmcfibro	control
TCGTAGACAGAGGCAT-1	Endothelial	endo	control
TCGTGCTAGCGTGAGT-1	Endothelial	endo	control
TCGTGGGTCAAAGCCT-1	Fibroblast	vsmcfibro	control
TCGTGGGTCTCGCAGG-1	B-cells	NA	control
TCTAACTAGTTTGTCG-1	B-cells	NA	control
TCTAACTGTATGCGGA-1	T-cells	NA	control
TCTACCGCATGATCTG-1	Fibroblast	vsmcfibro	control
TCTACCGTCACCTCTG-1	B-cells	NA	control
TCTACCGTCTGGTTGA-1	Fibroblast	vsmcfibro	control
TCTATACAGACGACTG-1	Fibroblast	vsmcfibro	control
TCTATACGTACTGTTG-1	B-cells	NA	control
TCTATACTCATCGCAA-1	VSMC	vsmcfibro	control
TCTATCACATTGAAGA-1	Endothelial	endo	control
TCTCCGATCTCTCGAC-1	RBC	NA	control
TCTCCGATCTGGTGGC-1	RBC	NA	control
TCTCTGGAGCATCAGG-1	RBC	NA	control
TCTGCCACAGTTGTTG-1	Fibroblast	vsmcfibro	control
TCTGGCTAGCGAACTG-1	RBC	NA	control
TCTTAGTCATCTCCCA-1	B-cells	NA	control
TCTTAGTGTGTGTTTG-1	RBC	NA	control
TCTTCCTAGGCATCTT-1	B-cells	NA	control
TCTTGCGAGAGTTGAT-1	RBC	NA	control
TGAACGTAGCTGGCCT-1	Fibroblast	vsmcfibro	control
TGAACGTGTGCCGGTT-1	RBC	NA	control
TGACCCTCAGATCACT-1	RBC	NA	control
TGACCCTCATGGCTAT-1	VSMC	vsmcfibro	control
TGACTCCAGTCTTCCC-1	Fibroblast	vsmcfibro	control
TGAGACTAGAGGATCC-1	T-cells	NA	control
TGAGCATTCGCGCCAA-1	T-cells	NA	control
TGAGCGCGTTGTAGCT-1	Fibroblast	vsmcfibro	control
TGAGGAGAGGCATCTT-1	Endothelial	endo	control
TGAGGAGAGGCGTTAG-1	B-cells	NA	control
TGAGGAGGTCTGCATA-1	Fibroblast	vsmcfibro	control
TGAGGAGTCCGATCTC-1	Fibroblast	vsmcfibro	control
TGAGGGAAGTGCAGCA-1	B-cells	NA	control
TGAGGGACACTATCGA-1	Fibroblast	vsmcfibro	control
TGAGGGACACTGCATA-1	Fibroblast	vsmcfibro	control
TGAGGGAGTATAGGAT-1	Macrophages	NA	control
TGAGGGAGTCAGTCTA-1	Fibroblast	vsmcfibro	control
TGAGGTTGTACCATAC-1	Fibroblast	vsmcfibro	control
TGAGGTTGTTAAAGTG-1	Macrophages	NA	control
TGATCAGTCGAGTCCG-1	Macrophages	NA	control
TGATCTTGTTGCATTG-1	Fibroblast	vsmcfibro	control
TGATCTTTCATCTATC-1	T-cells	NA	control
TGATGCACACTGAATC-1	B-cells	NA	control
TGATGGTCATCACGGC-1	Endothelial	endo	control
TGATGGTGTGTGAGCA-1	Macrophages	NA	control
TGATTCTTCGGTAAGG-1	Fibroblast	vsmcfibro	control
TGATTCTTCTACCCAC-1	T-cells	NA	control
TGCATGATCCCGTGTT-1	Fibroblast	vsmcfibro	control
TGCGATAGTTCTAACG-1	Fibroblast	vsmcfibro	control
TGCGGCAAGTTAGTAG-1	Fibroblast	vsmcfibro	control
TGCGGGTAGACGAAGA-1	Endothelial	endo	control
TGCTCCAGTAGTTAGA-1	Fibroblast	vsmcfibro	control
TGCTCCATCCCGAACG-1	Macrophages	NA	control
TGCTTGCAGTCAGGGT-1	Endothelial	endo	control
TGCTTGCCAGCTGTTA-1	T-cells	NA	control
TGCTTGCTCGGTCACG-1	Fibroblast	vsmcfibro	control
TGGAGAGAGGCTATCT-1	Endothelial	endo	control
TGGAGAGTCCTCATAT-1	RBC	NA	control
TGGAGGAGTTACGTAC-1	RBC	NA	control
TGGATCACATTATGCG-1	Macrophages	NA	control
TGGATCATCCCTTCCC-1	T-cells	NA	control
TGGCGTGGTACTAAGA-1	Fibroblast	vsmcfibro	control
TGGGAAGAGCCATCCG-1	Fibroblast	vsmcfibro	control
TGGGAGACAGTCTGGC-1	RBC	NA	control
TGGGAGACATAATCCG-1	RBC	NA	control
TGGGAGAGTCTCAGAT-1	Fibroblast	vsmcfibro	control
TGGGCGTAGATGACCG-1	T-cells	NA	control
TGGGCGTAGCTAGATA-1	Macrophages	NA	control
TGGGCGTAGGCTAACG-1	Fibroblast	vsmcfibro	control
TGGGCTGCACGATTCA-1	T-cells	NA	control
TGGTACAAGGTTAAAC-1	Fibroblast	vsmcfibro	control
TGGTTAGAGGGTCAAC-1	Endothelial	endo	control
TGTAACGCAGTACTAC-1	Fibroblast	vsmcfibro	control
TGTAACGTCCATTTAC-1	T-cells	NA	control
TGTAAGCCAGTGTACT-1	B-cells	NA	control
TGTACAGAGCGTGCTC-1	Fibroblast	vsmcfibro	control
TGTACAGAGTCTAGCT-1	Endothelial	endo	control
TGTACAGCATGGAGAC-1	Fibroblast	vsmcfibro	control
TGTACAGTCCTAGCTC-1	T-cells	NA	control
TGTCCTGTCGAATCCA-1	T-cells	NA	control
TGTGAGTCAAAGGAGA-1	Endothelial	endo	control
TGTGAGTTCTACGGGC-1	B-cells	NA	control
TGTGATGAGCGGGTTA-1	RBC	NA	control
TGTGATGGTCCTCAGG-1	Fibroblast	vsmcfibro	control
TGTGATGTCCGTGGCA-1	Macrophages	NA	control
TGTGGCGAGAGCTGCA-1	T-cells	NA	control
TGTGGCGTCGCGTGAC-1	Fibroblast	vsmcfibro	control
TGTGTGAAGGTAAGTT-1	T-cells	NA	control
TGTGTGAGTGGATCGA-1	Macrophages	NA	control
TGTTCATCATGGTGGA-1	Fibroblast	vsmcfibro	control
TGTTGAGAGGATGAGA-1	Fibroblast	vsmcfibro	control
TGTTGAGCATTAGGCT-1	B-cells	NA	control
TGTTGGAAGCTTTGTG-1	Fibroblast	vsmcfibro	control
TGTTGGAAGTGCTAGG-1	Endothelial	endo	control
TGTTTGTTCAGGACAG-1	T-cells	NA	control
TGTTTGTTCTGTGTGA-1	Fibroblast	vsmcfibro	control
TTACCGCTCTGAACGT-1	Endothelial	endo	control
TTACGCCGTTCCGGTG-1	RBC	NA	control
TTACTGTCATTGTCGA-1	T-cells	NA	control
TTAGGCATCGTCAAAC-1	Fibroblast	vsmcfibro	control
TTAGGGTAGGTTACCT-1	RBC	NA	control
TTAGTCTCATCGTGCG-1	Endothelial	endo	control
TTAGTCTTCTTGAACG-1	Endothelial	endo	control
TTATTGCCATCGAAGG-1	T-cells	NA	control
TTATTGCGTAACAGTA-1	VSMC	vsmcfibro	control
TTATTGCGTCAAGCCC-1	Endothelial	endo	control
TTCAATCAGCATTTGC-1	Endothelial	endo	control
TTCAATCAGGCATGCA-1	Macrophages	NA	control
TTCACCGCAGCTGTAT-1	Fibroblast	vsmcfibro	control
TTCACGCAGGATGTTA-1	RBC	NA	control
TTCACGCTCATTCGTT-1	Endothelial	endo	control
TTCATTGGTGAGTAAT-1	Fibroblast	vsmcfibro	control
TTCCAATCATCTTCGC-1	Endothelial	endo	control
TTCCACGCAGTCCGTG-1	Macrophages	NA	control
TTCCGGTGTCCGGTCA-1	Fibroblast	vsmcfibro	control
TTCCGGTGTGGTCAAG-1	Fibroblast	vsmcfibro	control
TTCCGGTTCCTCCACA-1	Endothelial	endo	control
TTCCGTGTCTACGGGC-1	B-cells	NA	control
TTCCTCTAGTGCTCGC-1	T-cells	NA	control
TTCCTTCAGACGACGT-1	Endothelial	endo	control
TTCCTTCTCTCTGACC-1	Fibroblast	vsmcfibro	control
TTCGCTGGTGGTATGG-1	Macrophages	NA	control
TTCGCTGTCCAATCTT-1	Endothelial	endo	control
TTCGGTCGTTGTGCAT-1	VSMC	vsmcfibro	control
TTCTTCCAGCCTTCTC-1	RBC	NA	control
TTCTTCCCAGTTGTTG-1	VSMC	vsmcfibro	control
TTCTTCCGTACGTGAG-1	T-cells	NA	control
TTGAACGTCGGTTCAA-1	Endothelial	endo	control
TTGCATTAGATACCAA-1	Fibroblast	vsmcfibro	control
TTGCATTTCCAAGAGG-1	Endothelial	endo	control
TTGCCTGTCTTGGATG-1	Fibroblast	vsmcfibro	control
TTGCGTCGTCACTTAG-1	B-cells	NA	control
TTGGATGAGGAAGTGA-1	Endothelial	endo	control
TTGGATGCAGCTGTGC-1	RBC	NA	control
TTGGGATTCAATCGGT-1	Macrophages	NA	control
TTGGGCGCATCAGTCA-1	T-cells	NA	control
TTGGGCGCATGCACTA-1	B-cells	NA	control
TTGGGTAGTGAGCGAT-1	T-cells	NA	control
TTGGGTATCTCCAAGA-1	Fibroblast	vsmcfibro	control
TTGGTTTGTCGTTTCC-1	RBC	NA	control
TTGTGTTTCGCAGAGA-1	Endothelial	endo	control
TTGTGTTTCTAGAGCT-1	B-cells	NA	control
TTTACCAAGGATTCAA-1	Fibroblast	vsmcfibro	control
TTTACCAGTCTACTGA-1	T-cells	NA	control
TTTACGTAGGAAAGTG-1	Fibroblast	vsmcfibro	control
TTTAGTCCATACATCG-1	B-cells	NA	control
TTTAGTCGTCCACACG-1	Endothelial	endo	control
TTTAGTCGTGCCTGCA-1	Endothelial	endo	control
TTTATGCCAACAAGTA-1	RBC	NA	control
TTTATGCGTCTAGGTT-1	VSMC	vsmcfibro	control
TTTCACACACGACAGA-1	B-cells	NA	control
TTTCAGTTCTGACCCT-1	Fibroblast	vsmcfibro	control
TTTCGATAGACACACG-1	T-cells	NA	control
TTTCGATCACGTCGTG-1	VSMC	vsmcfibro	control
TTTCGATGTTTCGACA-1	Endothelial	endo	control
TTTGACTAGCTCCGAC-1	B-cells	NA	control
TTTGACTCATTGCAAC-1	B-cells	NA	control
TTTGGAGCACCGTCGA-1	Endothelial	endo	control
TTTGTTGCACAGTATC-1	Macrophages	NA	control
